Date,Expenses,Money_In,Total_Money,Money_Spent,Money_Left,Stock_On_Hand,Stock_To_Order
2024-01-01,427,428,10428,427,10001,125,479
2024-01-02,240,701,10702,240,10462,328,0
2024-01-03,171,409,10871,171,10700,792,0
2024-01-04,479,1316,12016,479,11537,189,402
2024-01-05,316,265,11802,316,11486,130,147
2024-01-06,211,676,12162,211,11951,617,0
2024-01-07,408,254,12205,408,11797,674,0
2024-01-08,201,1316,13113,201,12912,529,0
2024-01-09,212,1119,14031,212,13819,703,0
2024-01-10,242,213,14032,242,13790,877,0
2024-01-11,181,1065,14855,181,14674,448,0
2024-01-12,242,518,15192,242,14950,320,0
2024-01-13,490,889,15839,490,15349,204,0
2024-01-14,147,978,16327,147,16180,199,283
2024-01-15,276,1436,17616,276,17340,370,0
2024-01-16,122,1140,18480,122,18358,649,0
2024-01-17,163,975,19333,163,19170,180,382
2024-01-18,250,1487,20657,250,20407,733,0
2024-01-19,285,1382,21789,285,21504,296,0
2024-01-20,460,342,21846,460,21386,146,438
2024-01-21,216,792,22178,216,21962,181,219
2024-01-22,151,978,22940,151,22789,384,0
2024-01-23,332,947,23736,332,23404,266,0
2024-01-24,289,927,24331,289,24042,314,0
2024-01-25,443,746,24788,443,24345,818,0
2024-01-26,449,346,24691,449,24242,723,0
2024-01-27,425,550,24792,425,24367,646,0
2024-01-28,473,701,25068,473,24595,267,0
2024-01-29,336,977,25572,336,25236,376,0
2024-01-30,427,1340,26576,427,26149,324,0
2024-01-31,450,864,27013,450,26563,963,0
2024-02-01,493,314,26877,493,26384,334,0
2024-02-02,116,846,27230,116,27114,510,0
2024-02-03,237,335,27449,237,27212,316,0
2024-02-04,390,844,28056,390,27666,317,0
2024-02-05,435,1222,28888,435,28453,505,0
2024-02-06,429,1139,29592,429,29163,246,0
2024-02-07,235,485,29648,235,29413,352,0
2024-02-08,481,1349,30762,481,30281,651,0
2024-02-09,234,1397,31678,234,31444,538,0
2024-02-10,398,1017,32461,398,32063,470,0
2024-02-11,212,483,32546,212,32334,621,0
2024-02-12,352,386,32720,352,32368,873,0
2024-02-13,124,424,32792,124,32668,256,0
2024-02-14,421,527,33195,421,32774,911,0
2024-02-15,448,1064,33838,448,33390,710,0
2024-02-16,132,988,34378,132,34246,490,0
2024-02-17,405,1158,35404,405,34999,641,0
2024-02-18,228,1333,36332,228,36104,981,0
2024-02-19,105,434,36538,105,36433,798,0
2024-02-20,374,746,37179,374,36805,887,0
2024-02-21,428,896,37701,428,37273,214,0
2024-02-22,250,1090,38363,250,38113,261,0
2024-02-23,332,206,38319,332,37987,839,0
2024-02-24,468,739,38726,468,38258,612,0
2024-02-25,490,565,38823,490,38333,619,0
2024-02-26,154,1480,39813,154,39659,405,0
2024-02-27,427,1239,40898,427,40471,723,0
2024-02-28,201,513,40984,201,40783,482,0
2024-02-29,490,530,41313,490,40823,652,0
2024-03-01,498,1286,42109,498,41611,100,406
2024-03-02,265,1200,42811,265,42546,119,157
2024-03-03,285,829,43375,285,43090,345,0
2024-03-04,129,693,43783,129,43654,999,0
2024-03-05,390,361,44015,390,43625,187,474
2024-03-06,348,341,43966,348,43618,878,0
2024-03-07,372,457,44075,372,43703,231,0
2024-03-08,437,1173,44876,437,44439,662,0
2024-03-09,184,742,45181,184,44997,640,0
2024-03-10,410,1066,46063,410,45653,316,0
2024-03-11,376,611,46264,376,45888,830,0
2024-03-12,259,1017,46905,259,46646,787,0
2024-03-13,432,964,47610,432,47178,548,0
2024-03-14,364,1124,48302,364,47938,223,0
2024-03-15,226,660,48598,226,48372,165,273
2024-03-16,110,1404,49776,110,49666,667,0
2024-03-17,217,1405,51071,217,50854,325,0
2024-03-18,103,345,51199,103,51096,824,0
2024-03-19,423,320,51416,423,50993,334,0
2024-03-20,134,264,51257,134,51123,980,0
2024-03-21,269,345,51468,269,51199,626,0
2024-03-22,221,770,51969,221,51748,785,0
2024-03-23,348,638,52386,348,52038,652,0
2024-03-24,167,1369,53407,167,53240,690,0
2024-03-25,342,697,53937,342,53595,903,0
2024-03-26,342,1033,54628,342,54286,294,0
2024-03-27,148,398,54684,148,54536,774,0
2024-03-28,320,925,55461,320,55141,533,0
2024-03-29,310,1156,56297,310,55987,984,0
2024-03-30,473,310,56297,473,55824,789,0
2024-03-31,434,401,56225,434,55791,162,306
2024-04-01,472,894,56685,472,56213,919,0
2024-04-02,155,709,56922,155,56767,296,0
2024-04-03,197,1298,58065,197,57868,559,0
2024-04-04,171,1064,58932,171,58761,287,0
2024-04-05,242,1147,59908,242,59666,355,0
2024-04-06,138,1107,60773,138,60635,927,0
2024-04-07,381,400,61035,381,60654,151,433
2024-04-08,376,230,60884,376,60508,195,485
2024-04-09,221,540,61048,221,60827,516,0
2024-04-10,348,1185,62012,348,61664,318,0
2024-04-11,305,320,61984,305,61679,268,0
2024-04-12,294,204,61883,294,61589,499,0
2024-04-13,235,1131,62720,235,62485,392,0
2024-04-14,316,1338,63823,316,63507,777,0
2024-04-15,467,1196,64703,467,64236,258,0
2024-04-16,197,807,65043,197,64846,322,0
2024-04-17,129,1386,66232,129,66103,853,0
2024-04-18,377,324,66427,377,66050,865,0
2024-04-19,260,317,66367,260,66107,151,399
2024-04-20,344,1229,67336,344,66992,973,0
2024-04-21,371,522,67514,371,67143,158,360
2024-04-22,141,580,67723,141,67582,170,404
2024-04-23,134,681,68263,134,68129,513,0
2024-04-24,161,1366,69495,161,69334,352,0
2024-04-25,396,1417,70751,396,70355,140,417
2024-04-26,141,1058,71413,141,71272,773,0
2024-04-27,398,1357,72629,398,72231,635,0
2024-04-28,261,734,72965,261,72704,309,0
2024-04-29,442,843,73547,442,73105,344,0
2024-04-30,235,1010,74115,235,73880,234,0
2024-05-01,443,814,74694,443,74251,568,0
2024-05-02,261,348,74599,261,74338,109,334
2024-05-03,418,1353,75691,418,75273,202,0
2024-05-04,137,1301,76574,137,76437,318,0
2024-05-05,359,743,77180,359,76821,235,0
2024-05-06,278,340,77161,278,76883,1000,0
2024-05-07,225,956,77839,225,77614,391,0
2024-05-08,180,1097,78711,180,78531,953,0
2024-05-09,378,819,79350,378,78972,726,0
2024-05-10,434,1283,80255,434,79821,108,441
2024-05-11,383,813,80634,383,80251,779,0
2024-05-12,153,475,80726,153,80573,370,0
2024-05-13,159,419,80992,159,80833,860,0
2024-05-14,383,518,81351,383,80968,378,0
2024-05-15,244,1438,82406,244,82162,315,0
2024-05-16,467,902,83064,467,82597,308,0
2024-05-17,451,1498,84095,451,83644,973,0
2024-05-18,235,1235,84879,235,84644,600,0
2024-05-19,228,304,84948,228,84720,194,424
2024-05-20,316,766,85486,316,85170,145,101
2024-05-21,270,467,85637,270,85367,752,0
2024-05-22,234,530,85897,234,85663,859,0
2024-05-23,326,1329,86992,326,86666,822,0
2024-05-24,318,1348,88014,318,87696,109,157
2024-05-25,138,505,88201,138,88063,658,0
2024-05-26,118,956,89019,118,88901,696,0
2024-05-27,382,503,89404,382,89022,540,0
2024-05-28,165,285,89307,165,89142,415,0
2024-05-29,286,281,89423,286,89137,466,0
2024-05-30,207,711,89848,207,89641,782,0
2024-05-31,152,924,90565,152,90413,898,0
2024-06-01,386,1032,91445,386,91059,735,0
2024-06-02,483,516,91575,483,91092,342,0
2024-06-03,183,562,91654,183,91471,522,0
2024-06-04,112,567,92038,112,91926,854,0
2024-06-05,270,1043,92969,270,92699,921,0
2024-06-06,442,708,93407,442,92965,373,0
2024-06-07,181,421,93386,181,93205,491,0
2024-06-08,119,1163,94368,119,94249,327,0
2024-06-09,202,1142,95391,202,95189,458,0
2024-06-10,256,666,95855,256,95599,328,0
2024-06-11,112,595,96194,112,96082,508,0
2024-06-12,268,770,96852,268,96584,985,0
2024-06-13,135,771,97355,135,97220,459,0
2024-06-14,428,1243,98463,428,98035,509,0
2024-06-15,447,1298,99333,447,98886,439,0
2024-06-16,114,436,99322,114,99208,998,0
2024-06-17,233,565,99773,233,99540,694,0
2024-06-18,235,278,99818,235,99583,211,0
2024-06-19,405,1089,100672,405,100267,453,0
2024-06-20,473,842,101109,473,100636,546,0
2024-06-21,410,1247,101883,410,101473,218,0
2024-06-22,297,1380,102853,297,102556,294,0
2024-06-23,230,290,102846,230,102616,825,0
2024-06-24,323,203,102819,323,102496,632,0
2024-06-25,375,603,103099,375,102724,472,0
2024-06-26,320,343,103067,320,102747,780,0
2024-06-27,269,1476,104223,269,103954,421,0
2024-06-28,439,455,104409,439,103970,837,0
2024-06-29,253,1238,105208,253,104955,416,0
2024-06-30,441,1036,105991,441,105550,434,0
2024-07-01,306,805,106355,306,106049,667,0
2024-07-02,165,592,106641,165,106476,530,0
2024-07-03,440,976,107452,440,107012,793,0
2024-07-04,483,556,107568,483,107085,730,0
2024-07-05,391,816,107901,391,107510,515,0
2024-07-06,380,200,107710,380,107330,411,0
2024-07-07,246,630,107960,246,107714,540,0
2024-07-08,396,1442,109156,396,108760,770,0
2024-07-09,264,1152,109912,264,109648,552,0
2024-07-10,326,637,110285,326,109959,623,0
2024-07-11,342,547,110506,342,110164,774,0
2024-07-12,143,781,110945,143,110802,627,0
2024-07-13,439,1496,112298,439,111859,734,0
2024-07-14,271,391,112250,271,111979,938,0
2024-07-15,484,681,112660,484,112176,788,0
2024-07-16,258,660,112836,258,112578,925,0
2024-07-17,201,501,113079,201,112878,125,123
2024-07-18,225,1173,114051,225,113826,725,0
2024-07-19,493,349,114175,493,113682,566,0
2024-07-20,312,1489,115171,312,114859,689,0
2024-07-21,199,986,115845,199,115646,606,0
2024-07-22,304,699,116345,304,116041,251,0
2024-07-23,435,211,116252,435,115817,868,0
2024-07-24,494,418,116235,494,115741,897,0
2024-07-25,317,648,116389,317,116072,280,0
2024-07-26,456,1260,117332,456,116876,575,0
2024-07-27,125,1341,118217,125,118092,355,0
2024-07-28,162,1134,119226,162,119064,236,0
2024-07-29,337,1287,120351,337,120014,672,0
2024-07-30,404,849,120863,404,120459,873,0
2024-07-31,326,1454,121913,326,121587,934,0
2024-08-01,468,1233,122820,468,122352,536,0
2024-08-02,380,1113,123465,380,123085,262,0
2024-08-03,480,1172,124257,480,123777,560,0
2024-08-04,232,706,124483,232,124251,960,0
2024-08-05,426,767,125018,426,124592,884,0
2024-08-06,498,1267,125859,498,125361,596,0
2024-08-07,420,689,126050,420,125630,381,0
2024-08-08,325,358,125988,325,125663,830,0
2024-08-09,246,680,126343,246,126097,378,0
2024-08-10,271,854,126951,271,126680,653,0
2024-08-11,141,483,127163,141,127022,254,0
2024-08-12,218,984,128006,218,127788,810,0
2024-08-13,178,638,128426,178,128248,165,312
2024-08-14,308,877,129125,308,128817,655,0
2024-08-15,338,1051,129868,338,129530,163,205
2024-08-16,315,997,130527,315,130212,888,0
2024-08-17,399,240,130452,399,130053,977,0
2024-08-18,491,1379,131432,491,130941,489,0
2024-08-19,344,212,131153,344,130809,460,0
2024-08-20,252,998,131807,252,131555,973,0
2024-08-21,314,1302,132857,314,132543,865,0
2024-08-22,476,1318,133861,476,133385,919,0
2024-08-23,408,651,134036,408,133628,599,0
2024-08-24,212,758,134386,212,134174,546,0
2024-08-25,348,259,134433,348,134085,498,0
2024-08-26,272,1028,135113,272,134841,841,0
2024-08-27,184,1157,135998,184,135814,230,0
2024-08-28,418,1293,137107,418,136689,127,301
2024-08-29,403,1355,138044,403,137641,778,0
2024-08-30,113,371,138012,113,137899,758,0
2024-08-31,319,477,138376,319,138057,987,0
2024-09-01,336,572,138629,336,138293,151,233
2024-09-02,294,870,139163,294,138869,316,0
2024-09-03,332,869,139738,332,139406,445,0
2024-09-04,489,976,140382,489,139893,384,0
2024-09-05,485,1063,140956,485,140471,358,0
2024-09-06,141,1163,141634,141,141493,119,483
2024-09-07,376,306,141799,376,141423,458,0
2024-09-08,214,340,141763,214,141549,899,0
2024-09-09,433,282,141831,433,141398,872,0
2024-09-10,115,706,142104,115,141989,304,0
2024-09-11,110,1472,143461,110,143351,256,0
2024-09-12,222,458,143809,222,143587,584,0
2024-09-13,442,434,144021,442,143579,677,0
2024-09-14,211,1152,144731,211,144520,816,0
2024-09-15,231,955,145475,231,145244,271,0
2024-09-16,410,1443,146687,410,146277,865,0
2024-09-17,467,434,146711,467,146244,896,0
2024-09-18,183,837,147081,183,146898,210,0
2024-09-19,396,252,147150,396,146754,419,0
2024-09-20,394,968,147722,394,147328,506,0
2024-09-21,466,606,147934,466,147468,177,403
2024-09-22,453,1484,148952,453,148499,348,0
2024-09-23,152,817,149316,152,149164,970,0
2024-09-24,450,1429,150593,450,150143,924,0
2024-09-25,161,1359,151502,161,151341,901,0
2024-09-26,121,911,152252,121,152131,645,0
2024-09-27,319,958,153089,319,152770,170,359
2024-09-28,431,898,153668,431,153237,112,315
2024-09-29,350,416,153653,350,153303,543,0
2024-09-30,285,1141,154444,285,154159,824,0
2024-10-01,178,1091,155250,178,155072,280,0
2024-10-02,475,1268,156340,475,155865,766,0
2024-10-03,238,1461,157326,238,157088,927,0
2024-10-04,375,1190,158278,375,157903,576,0
2024-10-05,323,1413,159316,323,158993,374,0
2024-10-06,265,702,159695,265,159430,950,0
2024-10-07,144,771,160201,144,160057,561,0
2024-10-08,224,1151,161208,224,160984,683,0
2024-10-09,412,976,161960,412,161548,444,0
2024-10-10,114,1212,162760,114,162646,971,0
2024-10-11,266,572,163218,266,162952,599,0
2024-10-12,208,926,163878,208,163670,916,0
2024-10-13,232,897,164567,232,164335,386,0
2024-10-14,405,765,165100,405,164695,669,0
2024-10-15,105,1258,165953,105,165848,295,0
2024-10-16,143,694,166542,143,166399,837,0
2024-10-17,308,1200,167599,308,167291,668,0
2024-10-18,488,692,167983,488,167495,807,0
2024-10-19,343,1205,168700,343,168357,558,0
2024-10-20,108,390,168747,108,168639,401,0
2024-10-21,213,1028,169667,213,169454,808,0
2024-10-22,224,827,170281,224,170057,779,0
2024-10-23,397,955,171012,397,170615,584,0
2024-10-24,383,1287,171902,383,171519,452,0
2024-10-25,317,1327,172846,317,172529,438,0
2024-10-26,280,1129,173658,280,173378,377,0
2024-10-27,256,714,174092,256,173836,336,0
2024-10-28,161,594,174430,161,174269,423,0
2024-10-29,161,1297,175566,161,175405,880,0
2024-10-30,453,579,175984,453,175531,296,0
2024-10-31,210,1191,176722,210,176512,383,0
2024-11-01,470,1407,177919,470,177449,878,0
2024-11-02,368,1422,178871,368,178503,389,0
2024-11-03,151,597,179100,151,178949,403,0
2024-11-04,216,939,179888,216,179672,283,0
2024-11-05,254,228,179900,254,179646,825,0
2024-11-06,373,459,180105,373,179732,380,0
2024-11-07,123,311,180043,123,179920,666,0
2024-11-08,249,458,180378,249,180129,753,0
2024-11-09,485,1205,181334,485,180849,205,0
2024-11-10,106,1375,182224,106,182118,391,0
2024-11-11,340,1180,183298,340,182958,551,0
2024-11-12,274,577,183535,274,183261,152,229
2024-11-13,344,433,183694,344,183350,941,0
2024-11-14,133,1020,184370,133,184237,603,0
2024-11-15,137,1381,185618,137,185481,744,0
2024-11-16,451,309,185790,451,185339,255,0
2024-11-17,176,1352,186691,176,186515,411,0
2024-11-18,143,708,187223,143,187080,221,0
2024-11-19,385,1052,188132,385,187747,720,0
2024-11-20,405,1466,189213,405,188808,331,0
2024-11-21,497,1270,190078,497,189581,489,0
2024-11-22,330,1106,190687,330,190357,404,0
2024-11-23,401,1078,191435,401,191034,412,0
2024-11-24,391,1471,192505,391,192114,161,412
2024-11-25,478,403,192517,478,192039,881,0
2024-11-26,206,1481,193520,206,193314,316,0
2024-11-27,235,366,193680,235,193445,260,0
2024-11-28,222,555,194000,222,193778,665,0
2024-11-29,138,520,194298,138,194160,102,309
2024-11-30,330,1416,195576,330,195246,581,0
2024-12-01,249,266,195512,249,195263,337,0
2024-12-02,247,779,196042,247,195795,819,0
2024-12-03,332,345,196140,332,195808,803,0
2024-12-04,219,741,196549,219,196330,906,0
2024-12-05,420,1407,197737,420,197317,777,0
2024-12-06,201,1070,198387,201,198186,217,0
2024-12-07,378,660,198846,378,198468,763,0
2024-12-08,176,744,199212,176,199036,946,0
2024-12-09,172,346,199382,172,199210,161,184
2024-12-10,257,1418,200628,257,200371,866,0
2024-12-11,391,791,201162,391,200771,549,0
2024-12-12,163,1159,201930,163,201767,805,0
2024-12-13,255,1024,202791,255,202536,378,0
2024-12-14,356,1305,203841,356,203485,605,0
2024-12-15,324,364,203849,324,203525,712,0
2024-12-16,120,1084,204609,120,204489,852,0
2024-12-17,265,1436,205925,265,205660,356,0
2024-12-18,113,387,206047,113,205934,334,0
2024-12-19,445,1378,207312,445,206867,701,0
2024-12-20,110,751,207618,110,207508,690,0
2024-12-21,120,558,208066,120,207946,581,0
2024-12-22,365,1105,209051,365,208686,384,0
2024-12-23,192,1398,210084,192,209892,546,0
2024-12-24,425,1207,211099,425,210674,193,340
2024-12-25,278,1036,211710,278,211432,441,0
2024-12-26,264,414,211846,264,211582,978,0
2024-12-27,182,875,212457,182,212275,521,0
2024-12-28,455,1214,213489,455,213034,395,0
2024-12-29,439,1020,214054,439,213615,933,0
2024-12-30,489,1326,214941,489,214452,137,332
2024-12-31,145,844,215296,145,215151,358,0
2025-01-01,265,437,215588,265,215323,891,0
2025-01-02,306,1253,216576,306,216270,944,0
2025-01-03,100,1311,217581,100,217481,573,0
2025-01-04,311,311,217792,311,217481,292,0
2025-01-05,365,940,218421,365,218056,737,0
2025-01-06,487,1220,219276,487,218789,740,0
2025-01-07,326,305,219094,326,218768,308,0
2025-01-08,236,1324,220092,236,219856,234,0
2025-01-09,247,1097,220953,247,220706,815,0
2025-01-10,348,448,221154,348,220806,129,422
2025-01-11,411,690,221496,411,221085,826,0
2025-01-12,181,836,221921,181,221740,664,0
2025-01-13,107,1331,223071,107,222964,517,0
2025-01-14,147,660,223624,147,223477,961,0
2025-01-15,158,1145,224622,158,224464,220,0
2025-01-16,431,515,224979,431,224548,610,0
2025-01-17,466,797,225345,466,224879,621,0
2025-01-18,461,759,225638,461,225177,525,0
2025-01-19,347,1167,226344,347,225997,349,0
2025-01-20,333,1328,227325,333,226992,248,0
2025-01-21,296,590,227582,296,227286,713,0
2025-01-22,360,479,227765,360,227405,984,0
2025-01-23,135,765,228170,135,228035,891,0
2025-01-24,312,896,228931,312,228619,906,0
2025-01-25,359,747,229366,359,229007,940,0
2025-01-26,101,779,229786,101,229685,843,0
2025-01-27,252,1402,231087,252,230835,693,0
2025-01-28,437,1202,232037,437,231600,986,0
2025-01-29,176,1114,232714,176,232538,651,0
2025-01-30,347,906,233444,347,233097,440,0
2025-01-31,382,1312,234409,382,234027,486,0
2025-02-01,333,859,234886,333,234553,990,0
2025-02-02,196,689,235242,196,235046,685,0
2025-02-03,296,678,235724,296,235428,976,0
2025-02-04,497,1041,236469,497,235972,144,262
2025-02-05,481,1168,237140,481,236659,822,0
2025-02-06,295,990,237649,295,237354,779,0
2025-02-07,433,511,237865,433,237432,607,0
2025-02-08,118,458,237890,118,237772,614,0
2025-02-09,402,879,238651,402,238249,990,0
2025-02-10,151,1101,239350,151,239199,202,0
2025-02-11,369,1135,240334,369,239965,115,469
2025-02-12,173,1039,241004,173,240831,991,0
2025-02-13,435,516,241347,435,240912,176,340
2025-02-14,500,742,241654,500,241154,446,0
2025-02-15,419,1014,242168,419,241749,765,0
2025-02-16,141,872,242621,141,242480,972,0
2025-02-17,445,1292,243772,445,243327,489,0
2025-02-18,262,1483,244810,262,244548,835,0
2025-02-19,488,1199,245747,488,245259,993,0
2025-02-20,377,273,245532,377,245155,732,0
2025-02-21,135,680,245835,135,245700,746,0
2025-02-22,450,788,246488,450,246038,332,0
2025-02-23,482,385,246423,482,245941,544,0
2025-02-24,150,1497,247438,150,247288,820,0
2025-02-25,151,1108,248396,151,248245,270,0
2025-02-26,455,813,249058,455,248603,129,123
2025-02-27,266,314,248917,266,248651,400,0
2025-02-28,283,967,249618,283,249335,541,0
2025-03-01,174,700,250035,174,249861,643,0
2025-03-02,310,1359,251220,310,250910,798,0
2025-03-03,192,548,251458,192,251266,279,0
2025-03-04,140,1448,252714,140,252574,991,0
2025-03-05,295,1469,254043,295,253748,799,0
2025-03-06,223,1219,254967,223,254744,697,0
2025-03-07,173,675,255419,173,255246,572,0
2025-03-08,426,720,255966,426,255540,570,0
2025-03-09,230,219,255759,230,255529,923,0
2025-03-10,338,789,256318,338,255980,793,0
2025-03-11,379,523,256503,379,256124,175,326
2025-03-12,276,1403,257527,276,257251,406,0
2025-03-13,427,1068,258319,427,257892,806,0
2025-03-14,228,1135,259027,228,258799,965,0
2025-03-15,254,607,259406,254,259152,493,0
2025-03-16,347,418,259570,347,259223,342,0
2025-03-17,295,1371,260594,295,260299,467,0
2025-03-18,394,805,261104,394,260710,816,0
2025-03-19,251,244,260954,251,260703,949,0
2025-03-20,437,1010,261713,437,261276,381,0
2025-03-21,104,1359,262635,104,262531,985,0
2025-03-22,451,300,262831,451,262380,720,0
2025-03-23,481,1217,263597,481,263116,952,0
2025-03-24,246,671,263787,246,263541,721,0
2025-03-25,280,648,264189,280,263909,751,0
2025-03-26,197,1471,265380,197,265183,356,0
2025-03-27,447,480,265663,447,265216,743,0
2025-03-28,149,1485,266701,149,266552,761,0
2025-03-29,120,832,267384,120,267264,907,0
2025-03-30,325,268,267532,325,267207,693,0
2025-03-31,286,469,267676,286,267390,192,251
2025-04-01,267,1050,268440,267,268173,279,0
2025-04-02,202,470,268643,202,268441,905,0
2025-04-03,376,949,269390,376,269014,643,0
2025-04-04,356,758,269772,356,269416,950,0
2025-04-05,184,726,270142,184,269958,944,0
2025-04-06,346,804,270762,346,270416,864,0
2025-04-07,273,435,270851,273,270578,579,0
2025-04-08,138,488,271066,138,270928,872,0
2025-04-09,215,1013,271941,215,271726,966,0
2025-04-10,385,949,272675,385,272290,192,302
2025-04-11,107,741,273031,107,272924,649,0
2025-04-12,163,1131,274055,163,273892,477,0
2025-04-13,444,736,274628,444,274184,698,0
2025-04-14,295,960,275144,295,274849,210,0
2025-04-15,445,678,275527,445,275082,582,0
2025-04-16,112,1468,276550,112,276438,674,0
2025-04-17,267,1449,277887,267,277620,326,0
2025-04-18,431,329,277949,431,277518,750,0
2025-04-19,337,818,278336,337,277999,764,0
2025-04-20,309,438,278437,309,278128,243,0
2025-04-21,123,276,278404,123,278281,411,0
2025-04-22,352,437,278718,352,278366,199,220
2025-04-23,375,477,278843,375,278468,497,0
2025-04-24,332,959,279427,332,279095,786,0
2025-04-25,480,1306,280401,480,279921,529,0
2025-04-26,400,516,280437,400,280037,524,0
2025-04-27,435,402,280439,435,280004,953,0
2025-04-28,350,1460,281464,350,281114,517,0
2025-04-29,243,267,281381,243,281138,806,0
2025-04-30,289,644,281782,289,281493,554,0
2025-05-01,327,683,282176,327,281849,975,0
2025-05-02,285,403,282252,285,281967,802,0
2025-05-03,288,1315,283282,288,282994,760,0
2025-05-04,283,324,283318,283,283035,507,0
2025-05-05,241,588,283623,241,283382,225,0
2025-05-06,332,387,283769,332,283437,778,0
2025-05-07,208,1422,284859,208,284651,121,125
2025-05-08,270,698,285349,270,285079,228,0
2025-05-09,389,620,285699,389,285310,170,491
2025-05-10,383,624,285934,383,285551,700,0
2025-05-11,210,677,286228,210,286018,436,0
2025-05-12,496,502,286520,496,286024,907,0
2025-05-13,405,205,286229,405,285824,383,0
2025-05-14,174,466,286290,174,286116,653,0
2025-05-15,228,557,286673,228,286445,212,0
2025-05-16,438,252,286697,438,286259,234,0
2025-05-17,107,933,287192,107,287085,908,0
2025-05-18,221,1405,288490,221,288269,431,0
2025-05-19,108,556,288825,108,288717,371,0
2025-05-20,126,459,289176,126,289050,859,0
2025-05-21,315,1277,290327,315,290012,216,0
2025-05-22,481,330,290342,481,289861,587,0
2025-05-23,329,941,290802,329,290473,625,0
2025-05-24,403,423,290896,403,290493,562,0
2025-05-25,357,653,291146,357,290789,729,0
2025-05-26,122,1267,292056,122,291934,408,0
2025-05-27,334,263,292197,334,291863,162,345
2025-05-28,305,1073,292936,305,292631,802,0
2025-05-29,155,1204,293835,155,293680,829,0
2025-05-30,327,350,294030,327,293703,182,264
2025-05-31,411,503,294206,411,293795,167,164
2025-06-01,240,1478,295273,240,295033,748,0
2025-06-02,399,1323,296356,399,295957,829,0
2025-06-03,266,980,296937,266,296671,711,0
2025-06-04,371,803,297474,371,297103,564,0
2025-06-05,358,1439,298542,358,298184,540,0
2025-06-06,150,434,298618,150,298468,973,0
2025-06-07,435,1329,299797,435,299362,838,0
2025-06-08,210,1080,300442,210,300232,562,0
2025-06-09,216,1047,301279,216,301063,447,0
2025-06-10,332,1016,302079,332,301747,525,0
2025-06-11,473,394,302141,473,301668,420,0
2025-06-12,318,840,302508,318,302190,781,0
2025-06-13,230,966,303156,230,302926,256,0
2025-06-14,451,1171,304097,451,303646,168,146
2025-06-15,143,390,304036,143,303893,542,0
2025-06-16,149,963,304856,149,304707,931,0
2025-06-17,166,1339,306046,166,305880,161,400
2025-06-18,387,1350,307230,387,306843,437,0
2025-06-19,443,450,307293,443,306850,520,0
2025-06-20,281,1066,307916,281,307635,988,0
2025-06-21,469,305,307940,469,307471,394,0
2025-06-22,407,839,308310,407,307903,460,0
2025-06-23,153,1383,309286,153,309133,619,0
2025-06-24,208,516,309649,208,309441,772,0
2025-06-25,346,659,310100,346,309754,967,0
2025-06-26,155,917,310671,155,310516,965,0
2025-06-27,384,952,311468,384,311084,217,0
2025-06-28,490,770,311854,490,311364,687,0
2025-06-29,215,1078,312442,215,312227,965,0
2025-06-30,387,1473,313700,387,313313,728,0
2025-07-01,445,1340,314653,445,314208,126,411
2025-07-02,436,747,314955,436,314519,129,192
2025-07-03,239,832,315351,239,315112,447,0
2025-07-04,279,212,315324,279,315045,285,0
2025-07-05,173,1359,316404,173,316231,773,0
2025-07-06,305,342,316573,305,316268,245,0
2025-07-07,479,1496,317764,479,317285,131,146
2025-07-08,482,1286,318571,482,318089,320,0
2025-07-09,292,1059,319148,292,318856,564,0
2025-07-10,274,522,319378,274,319104,478,0
2025-07-11,259,864,319968,259,319709,895,0
2025-07-12,390,1421,321130,390,320740,186,126
2025-07-13,179,522,321262,179,321083,872,0
2025-07-14,416,301,321384,416,320968,790,0
2025-07-15,141,757,321725,141,321584,553,0
2025-07-16,438,1068,322652,438,322214,597,0
2025-07-17,410,1105,323319,410,322909,524,0
2025-07-18,239,641,323550,239,323311,873,0
2025-07-19,362,433,323744,362,323382,453,0
2025-07-20,320,427,323809,320,323489,390,0
2025-07-21,447,1414,324903,447,324456,598,0
2025-07-22,369,831,325287,369,324918,146,212
2025-07-23,302,1427,326345,302,326043,156,103
2025-07-24,204,817,326860,204,326656,316,0
2025-07-25,492,481,327137,492,326645,882,0
2025-07-26,230,792,327437,230,327207,435,0
2025-07-27,161,215,327422,161,327261,609,0
2025-07-28,482,1081,328342,482,327860,279,0
2025-07-29,166,978,328838,166,328672,645,0
2025-07-30,460,671,329343,460,328883,612,0
2025-07-31,386,925,329808,386,329422,173,303
2025-08-01,479,286,329708,479,329229,546,0
2025-08-02,109,1141,330370,109,330261,179,260
2025-08-03,394,1079,331340,394,330946,687,0
2025-08-04,307,1055,332001,307,331694,396,0
2025-08-05,158,1029,332723,158,332565,121,266
2025-08-06,187,1465,334030,187,333843,571,0
2025-08-07,453,941,334784,453,334331,190,323
2025-08-08,154,698,335029,154,334875,546,0
2025-08-09,401,1020,335895,401,335494,636,0
2025-08-10,140,1010,336504,140,336364,991,0
2025-08-11,258,895,337259,258,337001,326,0
2025-08-12,270,544,337545,270,337275,178,361
2025-08-13,424,433,337708,424,337284,643,0
2025-08-14,361,597,337881,361,337520,894,0
2025-08-15,278,919,338439,278,338161,844,0
2025-08-16,430,502,338663,430,338233,341,0
2025-08-17,152,499,338732,152,338580,362,0
2025-08-18,201,555,339135,201,338934,716,0
2025-08-19,178,354,339288,178,339110,281,0
2025-08-20,495,1486,340596,495,340101,605,0
2025-08-21,337,1354,341455,337,341118,878,0
2025-08-22,396,1119,342237,396,341841,797,0
2025-08-23,389,1479,343320,389,342931,430,0
2025-08-24,421,847,343778,421,343357,254,0
2025-08-25,325,339,343696,325,343371,580,0
2025-08-26,326,1493,344864,326,344538,410,0
2025-08-27,240,1411,345949,240,345709,157,280
2025-08-28,359,351,346060,359,345701,417,0
2025-08-29,336,1125,346826,336,346490,138,129
2025-08-30,288,787,347277,288,346989,178,430
2025-08-31,146,1459,348448,146,348302,708,0
2025-09-01,359,987,349289,359,348930,573,0
2025-09-02,397,1335,350265,397,349868,910,0
2025-09-03,478,284,350152,478,349674,560,0
2025-09-04,392,585,350259,392,349867,429,0
2025-09-05,409,1174,351041,409,350632,613,0
2025-09-06,177,326,350958,177,350781,561,0
2025-09-07,152,903,351684,152,351532,831,0
2025-09-08,143,1233,352765,143,352622,761,0
2025-09-09,188,280,352902,188,352714,353,0
2025-09-10,462,1096,353810,462,353348,549,0
2025-09-11,368,1270,354618,368,354250,724,0
2025-09-12,181,945,355195,181,355014,481,0
2025-09-13,244,993,356007,244,355763,518,0
2025-09-14,496,892,356655,496,356159,795,0
2025-09-15,406,307,356466,406,356060,908,0
2025-09-16,423,885,356945,423,356522,167,268
2025-09-17,148,1342,357864,148,357716,794,0
2025-09-18,297,781,358497,297,358200,358,0
2025-09-19,470,1434,359634,470,359164,994,0
2025-09-20,176,882,360046,176,359870,183,398
2025-09-21,439,489,360359,439,359920,458,0
2025-09-22,258,1002,360922,258,360664,232,0
2025-09-23,404,373,361037,404,360633,417,0
2025-09-24,386,971,361604,386,361218,758,0
2025-09-25,268,461,361679,268,361411,786,0
2025-09-26,459,1278,362689,459,362230,195,430
2025-09-27,443,1067,363297,443,362854,620,0
2025-09-28,285,237,363091,285,362806,471,0
2025-09-29,258,569,363375,258,363117,319,0
2025-09-30,274,1195,364312,274,364038,296,0
2025-10-01,215,481,364519,215,364304,258,0
2025-10-02,139,805,365109,139,364970,964,0
2025-10-03,151,1239,366209,151,366058,889,0
2025-10-04,376,1278,367336,376,366960,138,438
2025-10-05,272,1465,368425,272,368153,234,0
2025-10-06,405,971,369124,405,368719,257,0
2025-10-07,183,570,369289,183,369106,951,0
2025-10-08,454,1479,370585,454,370131,928,0
2025-10-09,184,1096,371227,184,371043,144,310
2025-10-10,286,686,371729,286,371443,554,0
2025-10-11,412,783,372226,412,371814,870,0
2025-10-12,483,1119,372933,483,372450,339,0
2025-10-13,373,689,373139,373,372766,416,0
2025-10-14,340,597,373363,340,373023,476,0
2025-10-15,447,1368,374391,447,373944,551,0
2025-10-16,336,777,374721,336,374385,896,0
2025-10-17,295,1229,375614,295,375319,640,0
2025-10-18,314,531,375850,314,375536,936,0
2025-10-19,202,1438,376974,202,376772,241,0
2025-10-20,228,306,377078,228,376850,756,0
2025-10-21,346,960,377810,346,377464,667,0
2025-10-22,152,1256,378720,152,378568,971,0
2025-10-23,163,783,379351,163,379188,185,490
2025-10-24,182,758,379946,182,379764,560,0
2025-10-25,362,501,380265,362,379903,950,0
2025-10-26,323,387,380290,323,379967,327,0
2025-10-27,330,915,380882,330,380552,127,312
2025-10-28,127,1011,381563,127,381436,614,0
2025-10-29,291,682,382118,291,381827,495,0
2025-10-30,141,967,382794,141,382653,329,0
2025-10-31,114,852,383505,114,383391,201,0
2025-11-01,465,886,384277,465,383812,910,0
2025-11-02,174,481,384293,174,384119,139,246
2025-11-03,341,484,384603,341,384262,877,0
2025-11-04,461,1160,385422,461,384961,559,0
2025-11-05,415,210,385171,415,384756,181,109
2025-11-06,231,641,385397,231,385166,955,0
2025-11-07,176,1323,386489,176,386313,844,0
2025-11-08,411,1280,387593,411,387182,533,0
2025-11-09,156,790,387972,156,387816,343,0
2025-11-10,254,449,388265,254,388011,148,222
2025-11-11,314,1475,389486,314,389172,568,0
2025-11-12,132,427,389599,132,389467,956,0
2025-11-13,355,1422,390889,355,390534,648,0
2025-11-14,108,1494,392028,108,391920,627,0
2025-11-15,394,695,392615,394,392221,835,0
2025-11-16,173,796,393017,173,392844,539,0
2025-11-17,100,1459,394303,100,394203,461,0
2025-11-18,223,1368,395571,223,395348,526,0
2025-11-19,195,375,395723,195,395528,636,0
2025-11-20,284,338,395866,284,395582,638,0
2025-11-21,378,1239,396821,378,396443,905,0
2025-11-22,359,1334,397777,359,397418,120,299
2025-11-23,340,289,397707,340,397367,750,0
2025-11-24,298,964,398331,298,398033,359,0
2025-11-25,482,233,398266,482,397784,465,0
2025-11-26,134,906,398690,134,398556,346,0
2025-11-27,475,1486,400042,475,399567,206,0
2025-11-28,495,1391,400958,495,400463,852,0
2025-11-29,487,880,401343,487,400856,236,0
2025-11-30,122,921,401777,122,401655,659,0
2025-12-01,273,558,402213,273,401940,950,0
2025-12-02,498,1151,403091,498,402593,812,0
2025-12-03,345,1493,404086,345,403741,286,0
2025-12-04,169,329,404070,169,403901,833,0
2025-12-05,497,1137,405038,497,404541,137,250
2025-12-06,203,289,404830,203,404627,910,0
2025-12-07,202,285,404912,202,404710,423,0
2025-12-08,258,1255,405965,258,405707,507,0
2025-12-09,378,1169,406876,378,406498,359,0
2025-12-10,118,591,407089,118,406971,392,0
2025-12-11,282,297,407268,282,406986,986,0
2025-12-12,435,879,407865,435,407430,379,0
2025-12-13,163,953,408383,163,408220,547,0
2025-12-14,304,1100,409320,304,409016,495,0
2025-12-15,273,582,409598,273,409325,608,0
2025-12-16,454,1218,410543,454,410089,476,0
2025-12-17,365,746,410835,365,410470,920,0
2025-12-18,142,1069,411539,142,411397,180,320
2025-12-19,408,569,411966,408,411558,658,0
2025-12-20,250,857,412415,250,412165,205,0
2025-12-21,140,871,413036,140,412896,776,0
2025-12-22,251,827,413723,251,413472,556,0
2025-12-23,408,1072,414544,408,414136,270,0
2025-12-24,453,1109,415245,453,414792,459,0
2025-12-25,328,286,415078,328,414750,844,0
2025-12-26,280,1459,416209,280,415929,545,0
2025-12-27,240,317,416246,240,416006,176,443
2025-12-28,426,1031,417037,426,416611,472,0
2025-12-29,362,527,417138,362,416776,131,173
2025-12-30,411,1097,417873,411,417462,135,164
2025-12-31,134,683,418145,134,418011,897,0
2026-01-01,430,950,418961,430,418531,470,0
2026-01-02,296,1361,419892,296,419596,133,409
2026-01-03,178,1121,420717,178,420539,479,0
2026-01-04,290,1109,421648,290,421358,881,0
2026-01-05,139,1375,422733,139,422594,240,0
2026-01-06,371,951,423545,371,423174,507,0
2026-01-07,260,770,423944,260,423684,355,0
2026-01-08,158,253,423937,158,423779,853,0
2026-01-09,195,1222,425001,195,424806,630,0
2026-01-10,298,1350,426156,298,425858,220,0
2026-01-11,234,733,426591,234,426357,820,0
2026-01-12,328,639,426996,328,426668,726,0
2026-01-13,246,1205,427873,246,427627,304,0
2026-01-14,162,477,428104,162,427942,973,0
2026-01-15,137,1125,429067,137,428930,276,0
2026-01-16,465,1111,430041,465,429576,189,449
2026-01-17,263,911,430487,263,430224,826,0
2026-01-18,133,1326,431550,133,431417,655,0
2026-01-19,248,814,432231,248,431983,971,0
2026-01-20,180,556,432539,180,432359,912,0
2026-01-21,285,1241,433600,285,433315,329,0
2026-01-22,162,611,433926,162,433764,911,0
2026-01-23,171,684,434448,171,434277,909,0
2026-01-24,352,253,434530,352,434178,469,0
2026-01-25,383,1372,435550,383,435167,477,0
2026-01-26,339,1329,436496,339,436157,232,0
2026-01-27,413,376,436533,413,436120,167,258
2026-01-28,303,1180,437300,303,436997,638,0
2026-01-29,310,1038,438035,310,437725,943,0
2026-01-30,394,351,438076,394,437682,228,0
2026-01-31,262,351,438033,262,437771,560,0
2026-02-01,338,1259,439030,338,438692,452,0
2026-02-02,165,1329,440021,165,439856,755,0
2026-02-03,400,572,440428,400,440028,886,0
2026-02-04,166,1086,441114,166,440948,614,0
2026-02-05,128,454,441402,128,441274,630,0
2026-02-06,178,822,442096,178,441918,268,0
2026-02-07,182,860,442778,182,442596,826,0
2026-02-08,215,908,443504,215,443289,631,0
2026-02-09,245,361,443650,245,443405,356,0
2026-02-10,200,1500,444905,200,444705,664,0
2026-02-11,240,456,445161,240,444921,740,0
2026-02-12,255,1458,446379,255,446124,646,0
2026-02-13,147,1229,447353,147,447206,756,0
2026-02-14,186,1412,448618,186,448432,694,0
2026-02-15,178,550,448982,178,448804,774,0
2026-02-16,419,1439,450243,419,449824,445,0
2026-02-17,388,284,450108,388,449720,945,0
2026-02-18,114,366,450086,114,449972,146,428
2026-02-19,494,1381,451353,494,450859,371,0
2026-02-20,433,631,451490,433,451057,885,0
2026-02-21,392,1053,452110,392,451718,732,0
2026-02-22,427,262,451980,427,451553,609,0
2026-02-23,421,1317,452870,421,452449,396,0
2026-02-24,428,818,453267,428,452839,594,0
2026-02-25,225,1031,453870,225,453645,404,0
2026-02-26,332,349,453994,332,453662,805,0
2026-02-27,130,523,454185,130,454055,550,0
2026-02-28,312,1191,455246,312,454934,575,0
2026-03-01,204,896,455830,204,455626,721,0
2026-03-02,173,840,456466,173,456293,982,0
2026-03-03,467,853,457146,467,456679,851,0
2026-03-04,276,1016,457695,276,457419,233,0
2026-03-05,489,958,458377,489,457888,627,0
2026-03-06,387,417,458305,387,457918,426,0
2026-03-07,223,1155,459073,223,458850,225,0
2026-03-08,236,1120,459970,236,459734,353,0
2026-03-09,172,398,460132,172,459960,151,248
2026-03-10,296,1460,461420,296,461124,528,0
2026-03-11,227,527,461651,227,461424,933,0
2026-03-12,267,1383,462807,267,462540,838,0
2026-03-13,260,588,463128,260,462868,881,0
2026-03-14,181,1220,464088,181,463907,627,0
2026-03-15,339,1221,465128,339,464789,1000,0
2026-03-16,257,1218,466007,257,465750,123,146
2026-03-17,301,1235,466985,301,466684,568,0
2026-03-18,223,640,467324,223,467101,697,0
2026-03-19,280,299,467400,280,467120,151,244
2026-03-20,353,1423,468543,353,468190,963,0
2026-03-21,434,1163,469353,434,468919,392,0
2026-03-22,374,216,469135,374,468761,967,0
2026-03-23,155,1082,469843,155,469688,237,0
2026-03-24,235,949,470637,235,470402,882,0
2026-03-25,306,949,471351,306,471045,146,305
2026-03-26,126,1367,472412,126,472286,675,0
2026-03-27,199,942,473228,199,473029,666,0
2026-03-28,247,350,473379,247,473132,495,0
2026-03-29,358,1122,474254,358,473896,882,0
2026-03-30,381,772,474668,381,474287,945,0
2026-03-31,419,1451,475738,419,475319,221,0
2026-04-01,165,398,475717,165,475552,503,0
2026-04-02,291,894,476446,291,476155,671,0
2026-04-03,287,495,476650,287,476363,303,0
2026-04-04,408,1242,477605,408,477197,511,0
2026-04-05,356,282,477479,356,477123,146,119
2026-04-06,170,882,478005,170,477835,923,0
2026-04-07,342,1263,479098,342,478756,567,0
2026-04-08,176,1441,480197,176,480021,627,0
2026-04-09,171,871,480892,171,480721,727,0
2026-04-10,263,532,481253,263,480990,502,0
2026-04-11,415,812,481802,415,481387,707,0
2026-04-12,272,1238,482625,272,482353,948,0
2026-04-13,360,1290,483643,360,483283,601,0
2026-04-14,462,1352,484635,462,484173,406,0
2026-04-15,343,234,484407,343,484064,477,0
2026-04-16,269,424,484488,269,484219,526,0
2026-04-17,398,830,485049,398,484651,915,0
2026-04-18,471,1488,486139,471,485668,127,405
2026-04-19,342,743,486411,342,486069,771,0
2026-04-20,500,1384,487453,500,486953,691,0
2026-04-21,216,305,487258,216,487042,697,0
2026-04-22,345,549,487591,345,487246,636,0
2026-04-23,422,1469,488715,422,488293,893,0
2026-04-24,294,502,488795,294,488501,941,0
2026-04-25,448,696,489197,448,488749,132,393
2026-04-26,458,425,489174,458,488716,295,0
2026-04-27,109,1103,489819,109,489710,421,0
2026-04-28,314,510,490220,314,489906,522,0
2026-04-29,453,617,490523,453,490070,520,0
2026-04-30,356,1452,491522,356,491166,582,0
2026-05-01,476,327,491493,476,491017,822,0
2026-05-02,170,1262,492279,170,492109,312,0
2026-05-03,387,865,492974,387,492587,778,0
2026-05-04,344,1276,493863,344,493519,485,0
2026-05-05,260,554,494073,260,493813,570,0
2026-05-06,372,901,494714,372,494342,659,0
2026-05-07,281,741,495083,281,494802,724,0
2026-05-08,347,593,495395,347,495048,352,0
2026-05-09,242,1342,496390,242,496148,405,0
2026-05-10,215,809,496957,215,496742,889,0
2026-05-11,247,624,497366,247,497119,806,0
2026-05-12,460,1201,498320,460,497860,424,0
2026-05-13,345,914,498774,345,498429,673,0
2026-05-14,469,760,499189,469,498720,394,0
2026-05-15,162,1374,500094,162,499932,792,0
2026-05-16,378,977,500909,378,500531,504,0
2026-05-17,276,499,501030,276,500754,397,0
2026-05-18,121,789,501543,121,501422,831,0
2026-05-19,140,909,502331,140,502191,552,0
2026-05-20,435,725,502916,435,502481,865,0
2026-05-21,345,638,503119,345,502774,306,0
2026-05-22,375,755,503529,375,503154,675,0
2026-05-23,456,756,503910,456,503454,240,0
2026-05-24,155,1460,504914,155,504759,858,0
2026-05-25,400,690,505449,400,505049,348,0
2026-05-26,125,1287,506336,125,506211,331,0
2026-05-27,426,676,506887,426,506461,153,151
2026-05-28,311,876,507337,311,507026,834,0
2026-05-29,341,405,507431,341,507090,797,0
2026-05-30,494,481,507571,494,507077,105,381
2026-05-31,180,1033,508110,180,507930,768,0
2026-06-01,343,1177,509107,343,508764,766,0
2026-06-02,202,788,509552,202,509350,428,0
2026-06-03,246,321,509671,246,509425,887,0
2026-06-04,145,1375,510800,145,510655,337,0
2026-06-05,373,276,510931,373,510558,279,0
2026-06-06,313,560,511118,313,510805,137,303
2026-06-07,353,581,511386,353,511033,866,0
2026-06-08,248,276,511309,248,511061,109,252
2026-06-09,390,1434,512495,390,512105,209,0
2026-06-10,271,782,512887,271,512616,565,0
2026-06-11,428,1312,513928,428,513500,636,0
2026-06-12,352,474,513974,352,513622,971,0
2026-06-13,358,1158,514780,358,514422,379,0
2026-06-14,198,430,514852,198,514654,438,0
2026-06-15,183,1139,515793,183,515610,763,0
2026-06-16,231,581,516191,231,515960,114,477
2026-06-17,272,804,516764,272,516492,681,0
2026-06-18,445,595,517087,445,516642,279,0
2026-06-19,412,1030,517672,412,517260,946,0
2026-06-20,318,1255,518515,318,518197,435,0
2026-06-21,144,1020,519217,144,519073,785,0
2026-06-22,148,578,519651,148,519503,243,0
2026-06-23,344,862,520365,344,520021,354,0
2026-06-24,103,734,520755,103,520652,492,0
2026-06-25,220,1114,521766,220,521546,871,0
2026-06-26,236,875,522421,236,522185,409,0
2026-06-27,398,1373,523558,398,523160,111,233
2026-06-28,434,936,524096,434,523662,809,0
2026-06-29,220,327,523989,220,523769,783,0
2026-06-30,160,1153,524922,160,524762,414,0
2026-07-01,181,1030,525792,181,525611,802,0
2026-07-02,357,836,526447,357,526090,806,0
2026-07-03,160,804,526894,160,526734,476,0
2026-07-04,414,652,527386,414,526972,324,0
2026-07-05,168,1179,528151,168,527983,256,0
2026-07-06,332,1440,529423,332,529091,482,0
2026-07-07,312,1324,530415,312,530103,582,0
2026-07-08,487,1300,531403,487,530916,921,0
2026-07-09,440,647,531563,440,531123,880,0
2026-07-10,226,1420,532543,226,532317,994,0
2026-07-11,141,1276,533593,141,533452,557,0
2026-07-12,370,940,534392,370,534022,179,388
2026-07-13,157,326,534348,157,534191,948,0
2026-07-14,380,1235,535426,380,535046,307,0
2026-07-15,393,1299,536345,393,535952,253,0
2026-07-16,184,871,536823,184,536639,974,0
2026-07-17,366,1104,537743,366,537377,219,0
2026-07-18,448,620,537997,448,537549,834,0
2026-07-19,398,1201,538750,398,538352,193,361
2026-07-20,328,313,538665,328,538337,564,0
2026-07-21,167,1251,539588,167,539421,525,0
2026-07-22,333,1354,540775,333,540442,159,386
2026-07-23,336,831,541273,336,540937,840,0
2026-07-24,111,1010,541947,111,541836,360,0
2026-07-25,101,646,542482,101,542381,692,0
2026-07-26,137,292,542673,137,542536,533,0
2026-07-27,276,330,542866,276,542590,654,0
2026-07-28,130,341,542931,130,542801,583,0
2026-07-29,116,787,543588,116,543472,518,0
2026-07-30,192,477,543949,192,543757,884,0
2026-07-31,428,1060,544817,428,544389,483,0
2026-08-01,295,1118,545507,295,545212,990,0
2026-08-02,293,969,546181,293,545888,182,449
2026-08-03,438,1304,547192,438,546754,236,0
2026-08-04,434,912,547666,434,547232,221,0
2026-08-05,191,1300,548532,191,548341,502,0
2026-08-06,370,460,548801,370,548431,845,0
2026-08-07,214,207,548638,214,548424,874,0
2026-08-08,111,811,549235,111,549124,574,0
2026-08-09,444,1315,550439,444,549995,534,0
2026-08-10,372,976,550971,372,550599,943,0
2026-08-11,217,706,551305,217,551088,571,0
2026-08-12,277,517,551605,277,551328,382,0
2026-08-13,196,431,551759,196,551563,132,438
2026-08-14,314,1459,553022,314,552708,884,0
2026-08-15,108,692,553400,108,553292,311,0
2026-08-16,134,406,553698,134,553564,708,0
2026-08-17,117,1114,554678,117,554561,712,0
2026-08-18,444,299,554860,444,554416,350,0
2026-08-19,479,290,554706,479,554227,511,0
2026-08-20,324,679,554906,324,554582,652,0
2026-08-21,211,315,554897,211,554686,243,0
2026-08-22,357,792,555478,357,555121,339,0
2026-08-23,474,1379,556500,474,556026,426,0
2026-08-24,395,1424,557450,395,557055,891,0
2026-08-25,444,856,557911,444,557467,342,0
2026-08-26,254,493,557960,254,557706,776,0
2026-08-27,366,652,558358,366,557992,523,0
2026-08-28,253,763,558755,253,558502,162,385
2026-08-29,402,558,559060,402,558658,741,0
2026-08-30,447,1074,559732,447,559285,669,0
2026-08-31,353,296,559581,353,559228,452,0
2026-09-01,429,980,560208,429,559779,904,0
2026-09-02,368,852,560631,368,560263,813,0
2026-09-03,313,1036,561299,313,560986,252,0
2026-09-04,253,970,561956,253,561703,288,0
2026-09-05,486,1301,563004,486,562518,584,0
2026-09-06,223,661,563179,223,562956,407,0
2026-09-07,462,495,563451,462,562989,925,0
2026-09-08,337,318,563307,337,562970,675,0
2026-09-09,311,1053,564023,311,563712,670,0
2026-09-10,371,474,564186,371,563815,497,0
2026-09-11,224,722,564537,224,564313,308,0
2026-09-12,269,361,564674,269,564405,560,0
2026-09-13,289,389,564794,289,564505,648,0
2026-09-14,470,590,565095,470,564625,152,237
2026-09-15,293,1438,566063,293,565770,717,0
2026-09-16,120,349,566119,120,565999,292,0
2026-09-17,489,1403,567402,489,566913,841,0
2026-09-18,443,1344,568257,443,567814,322,0
2026-09-19,345,627,568441,345,568096,990,0
2026-09-20,270,820,568916,270,568646,115,208
2026-09-21,197,440,569086,197,568889,864,0
2026-09-22,486,1180,570069,486,569583,348,0
2026-09-23,456,1437,571020,456,570564,820,0
2026-09-24,204,1012,571576,204,571372,345,0
2026-09-25,382,858,572230,382,571848,894,0
2026-09-26,244,979,572827,244,572583,577,0
